13 20
_#000#______________
_#...#______________
_#...############___
_#..............#___
_#....Z..Z..Z...#___
_#..............####
_#...________......1
_#...________......1
_#...________......1
_#..............####
_#...CCCCCCCC...#___
_#..............#___
_################___

ConnectRooms 0 1-3.txt 2
ConnectRooms 1 1-5.txt 0
