7 24
________________________
########################
0......................1
0........Z..Z..Z.......1
0......................1
########################
________________________

ConnectRooms 0 1-6.txt 0
ConnectRooms 1 1-5.txt 0
