13 18
______#111#_______
______#...#_______
______#...#_______
______#...#_______
___####...####____
___#.........#____
___#.........#____
___#...___...#____
___#...___...#####
___#...___.......0
___#.............0
___#....P........0
___###############

ConnectRooms 1 final_boss.txt 0