13 18
_______111________
_______...________
_______...________
______#...#_______
___####...####____
___#....F....#____
___#.........#____
___#...___...#____
___#...___...#####
___#...___.......0
___#.............0
___#....P........0
___###############

ConnectRooms 0 1-5.txt 0
ConnectRooms 1 before_final_boss.txt 0
Say 0 5 The Panda from the I2P I game? Maybe I can try talking to it.